
    prevent -  предотвращать

    ivolved -  участвует

    avoid   -  избегать

    urgent  -  срочный

    encourage  - поощрять

    stuck  -  застревать

    efficient - эффективный

    frontier -  граница

    approach  - подход

    proper    - надлежащий

    vital    - жизненно важный

    suggested  - предложенный

    influence -  влияние

    survey   -  опрос

    denotes  -  обозначать

    essential  - существенный

    assuarance  - гарантия

    transition  - переход

    intervene  - вмешиваться

    attempt   -  попытка

    ensure     -  обеспечивать

    confidence - уверенность

    excellence  - мастерство (превосходтво)

    investigate  - исследовать

    maintain  -  поддерживать

    considered -  считается

    discard   - отбрасывать

    arise  - возникать

    undesired - нежелательный

    essence  - сущность

    consider  -  рассматривать

    reflect - отражать

    improvement  -  улучшение

    toggles - переключение

    eventual  -  возможный

    particular - конкретный

    rid   -  избавиться

    purpose   -  цель

    ongoing  -  постоянный

    decision  -  решение  

    recognize   -  признавать

    introduce -  вводить

    amount   -  количество

    pitfalls   -  подводные камни










